"filename", "language", "HTML", "Markdown", "JSON", "JavaScript", "CSS", "comment", "blank", "total"
"c:\Users\Frank\LunchCount2024\LunchCountOLD\admin\adminPage.html", "HTML", 54, 0, 0, 0, 0, 8, 0, 62
"c:\Users\Frank\LunchCount2024\LunchCountOLD\admin\adminPage.js", "JavaScript", 0, 0, 0, 24, 0, 0, 6, 30
"c:\Users\Frank\LunchCount2024\LunchCountOLD\admin\adminSignIn.html", "HTML", 40, 0, 0, 0, 0, 2, 0, 42
"c:\Users\Frank\LunchCount2024\LunchCountOLD\admin\adminSignIn.js", "JavaScript", 0, 0, 0, 53, 0, 0, 4, 57
"c:\Users\Frank\LunchCount2024\LunchCountOLD\admin\adminStyles.css", "CSS", 0, 0, 0, 0, 22, 0, 0, 22
"c:\Users\Frank\LunchCount2024\LunchCountOLD\defaultPage.css", "CSS", 0, 0, 0, 0, 18, 0, 1, 19
"c:\Users\Frank\LunchCount2024\LunchCountOLD\in1dex.html", "HTML", 11, 0, 0, 0, 0, 0, 0, 11
"c:\Users\Frank\LunchCount2024\LunchCountOLD\mainPage.html", "HTML", 41, 0, 0, 0, 0, 3, 0, 44
"c:\Users\Frank\LunchCount2024\LunchCountOLD\mainPage.js", "JavaScript", 0, 0, 0, 37, 0, 0, 3, 40
"c:\Users\Frank\LunchCount2024\LunchCountOLD\main\mainPage.html", "HTML", 41, 0, 0, 0, 0, 3, 0, 44
"c:\Users\Frank\LunchCount2024\LunchCountOLD\main\mainPage.js", "JavaScript", 0, 0, 0, 37, 0, 0, 3, 40
"c:\Users\Frank\LunchCount2024\LunchCountOLD\main\signIn.js", "JavaScript", 0, 0, 0, 53, 0, 0, 4, 57
"c:\Users\Frank\LunchCount2024\LunchCountOLD\main\signInPage.html", "HTML", 39, 0, 0, 0, 0, 2, 0, 41
"c:\Users\Frank\LunchCount2024\LunchCountOLD\main\signInStyles.css", "CSS", 0, 0, 0, 0, 74, 0, 5, 79
"c:\Users\Frank\LunchCount2024\LunchCountOLD\main\styles.css", "CSS", 0, 0, 0, 0, 55, 0, 2, 57
"c:\Users\Frank\LunchCount2024\LunchCountOLD\package-lock.json", "JSON", 0, 0, 694, 0, 0, 0, 1, 695
"c:\Users\Frank\LunchCount2024\LunchCountOLD\package.json", "JSON", 0, 0, 21, 0, 0, 0, 1, 22
"c:\Users\Frank\LunchCount2024\LunchCountOLD\public\admin\adminPage.html", "HTML", 54, 0, 0, 0, 0, 8, 0, 62
"c:\Users\Frank\LunchCount2024\LunchCountOLD\public\admin\adminPage.js", "JavaScript", 0, 0, 0, 24, 0, 0, 6, 30
"c:\Users\Frank\LunchCount2024\LunchCountOLD\public\admin\adminSignIn.html", "HTML", 40, 0, 0, 0, 0, 2, 0, 42
"c:\Users\Frank\LunchCount2024\LunchCountOLD\public\admin\adminSignIn.js", "JavaScript", 0, 0, 0, 53, 0, 0, 4, 57
"c:\Users\Frank\LunchCount2024\LunchCountOLD\public\admin\adminStyles.css", "CSS", 0, 0, 0, 0, 22, 0, 0, 22
"c:\Users\Frank\LunchCount2024\LunchCountOLD\public\defaultPage.css", "CSS", 0, 0, 0, 0, 18, 0, 1, 19
"c:\Users\Frank\LunchCount2024\LunchCountOLD\public\in1dex.html", "HTML", 11, 0, 0, 0, 0, 0, 0, 11
"c:\Users\Frank\LunchCount2024\LunchCountOLD\public\main\mainPage.html", "HTML", 41, 0, 0, 0, 0, 3, 0, 44
"c:\Users\Frank\LunchCount2024\LunchCountOLD\public\main\mainPage.js", "JavaScript", 0, 0, 0, 37, 0, 0, 3, 40
"c:\Users\Frank\LunchCount2024\LunchCountOLD\public\main\signIn.js", "JavaScript", 0, 0, 0, 53, 0, 0, 4, 57
"c:\Users\Frank\LunchCount2024\LunchCountOLD\public\main\signInPage.html", "HTML", 39, 0, 0, 0, 0, 2, 0, 41
"c:\Users\Frank\LunchCount2024\LunchCountOLD\public\main\signInStyles.css", "CSS", 0, 0, 0, 0, 74, 0, 5, 79
"c:\Users\Frank\LunchCount2024\LunchCountOLD\public\main\styles.css", "CSS", 0, 0, 0, 0, 55, 0, 2, 57
"c:\Users\Frank\LunchCount2024\LunchCountOLD\server.js", "JavaScript", 0, 0, 0, 9, 0, 0, 4, 13
"c:\Users\Frank\LunchCount2024\LunchCountOLD\signIn.js", "JavaScript", 0, 0, 0, 53, 0, 0, 4, 57
"c:\Users\Frank\LunchCount2024\LunchCountOLD\signInPage.html", "HTML", 39, 0, 0, 0, 0, 2, 0, 41
"c:\Users\Frank\LunchCount2024\LunchCountOLD\signInStyles.css", "CSS", 0, 0, 0, 0, 74, 0, 5, 79
"c:\Users\Frank\LunchCount2024\LunchCountOLD\styles.css", "CSS", 0, 0, 0, 0, 55, 0, 2, 57
"c:\Users\Frank\LunchCount2024\README.md", "Markdown", 0, 3, 0, 0, 0, 0, 0, 3
"c:\Users\Frank\LunchCount2024\package-lock.json", "JSON", 0, 0, 777, 0, 0, 0, 1, 778
"c:\Users\Frank\LunchCount2024\package.json", "JSON", 0, 0, 24, 0, 0, 0, 1, 25
"c:\Users\Frank\LunchCount2024\public\admin\adminPage.html", "HTML", 34, 0, 0, 0, 0, 1, 0, 35
"c:\Users\Frank\LunchCount2024\public\admin\adminPage.js", "JavaScript", 0, 0, 0, 322, 0, 58, 14, 394
"c:\Users\Frank\LunchCount2024\public\admin\adminSignIn.html", "HTML", 44, 0, 0, 0, 0, 2, 0, 46
"c:\Users\Frank\LunchCount2024\public\admin\adminSignIn.js", "JavaScript", 0, 0, 0, 48, 0, 5, 3, 56
"c:\Users\Frank\LunchCount2024\public\admin\adminStyles.css", "CSS", 0, 0, 0, 0, 102, 3, 2, 107
"c:\Users\Frank\LunchCount2024\public\admin\subPages\changeLunch.html", "HTML", 66, 0, 0, 0, 0, 3, 6, 75
"c:\Users\Frank\LunchCount2024\public\admin\subPages\seeCount.html", "HTML", 46, 0, 0, 0, 0, 60, 4, 110
"c:\Users\Frank\LunchCount2024\public\defaultPage.css", "CSS", 0, 0, 0, 0, 56, 0, 5, 61
"c:\Users\Frank\LunchCount2024\public\defaultScripts.js", "JavaScript", 0, 0, 0, 3, 0, 0, 0, 3
"c:\Users\Frank\LunchCount2024\public\in1dex.html", "HTML", 11, 0, 0, 0, 0, 0, 0, 11
"c:\Users\Frank\LunchCount2024\public\main\mainPage.html", "HTML", 37, 0, 0, 0, 0, 3, 4, 44
"c:\Users\Frank\LunchCount2024\public\main\mainPage.js", "JavaScript", 0, 0, 0, 138, 0, 15, 10, 163
"c:\Users\Frank\LunchCount2024\public\main\mainStyles.css", "CSS", 0, 0, 0, 0, 86, 2, 2, 90
"c:\Users\Frank\LunchCount2024\public\main\redirects.css", "CSS", 0, 0, 0, 0, 28, 2, 1, 31
"c:\Users\Frank\LunchCount2024\public\main\redirects.html", "HTML", 35, 0, 0, 0, 0, 0, 0, 35
"c:\Users\Frank\LunchCount2024\public\main\redirects.js", "JavaScript", 0, 0, 0, 16, 0, 0, 0, 16
"c:\Users\Frank\LunchCount2024\public\main\signIn.js", "JavaScript", 0, 0, 0, 48, 0, 5, 3, 56
"c:\Users\Frank\LunchCount2024\public\main\signInPage.html", "HTML", 43, 0, 0, 0, 0, 2, 0, 45
"c:\Users\Frank\LunchCount2024\public\main\signInStyles.css", "CSS", 0, 0, 0, 0, 75, 0, 5, 80
"c:\Users\Frank\LunchCount2024\server.js", "JavaScript", 0, 0, 0, 230, 0, 28, 16, 274
"Total", "-", 766, 3, 1516, 1238, 814, 224, 147, 4708